XXXXXXXXXXXXXXXXXXXXXXXX
X  XXX    XX    XXXX   X
XX XXX XX    XX X    X X
XX XXX X  XX XX   XX X X
XX       X X  XX XXX   X
XXXX XXX   XX        XXX
XX   XXXX XXX X X XXX XX
X   XX    XXX X X      X
X X XX XX   X X X XXX XX
X X    XXXX X   XXX   XX
X XX X X X    X     XXXX
X    X X   X XX X X X  X
XX X X XX XXXX    X   XX
XX X   X     XX X XX XXX
X  X XXX XXX XX XX     X
X X        X XX X  XXXXX
X   XXXX X    X XX     X
X X    X X XX   XX X XXX
X   XX        X    X   X
XXXXXXXXXXXXXXXXXXXXXXXX